1 13 31
###############################
#p     ** *  1 * 2 *  * * *   #
# # # #*# # #*#*# # # #*#*#*# #
#  x* W   ***  *  1   *   * * #
# # # # # #*# # #*#*# # # # #*#
# B F  f   x **  *  *   1     #
# # # # # # # # # #*# #*# # # #
#*  *  b   *  *      *        #
# # # # #*# # # #*#*# # # # # #
#*    **  *   s   *      3    #
# #*# # # # # # #*# # # # # # #
#       1   *   *  *          #
###############################
