1 13 31
###############################
#p     ** *  1 * 2 *  * * *   #
# # # #*# # #*#*# # # #*#*#*# #
#  x*     ***  *  1   *   * * #
# # # # # #*# # #*#*# # # # #*#
#      f   x **  *  *   1     #
# # # # # # # # # #*# #*# # # #
#*  *  b   *  *      *        #
# # # # #*# # # #*#*# # # # # #
#*    **  *   s   *      3    #
# #*# # # # # # #*# # # # # # #
#       1   *   *  *          #
###############################
