2 13 31
###############################
#      ** *  1 * 2 *  * * *   #
# # # #*# # #*#*# # # #*#*#*# #
#   *  b  ***  *  1   * 2 * * #
# # # # # #*# # #*#*# # # # #*#
#      f   x **  *  *   1     #
# # # # # # # # # #*# #*# # # #
#*  *  b   *  *      *        #
# # # # #*# # # #*#*# # # # # #
#* 3  **  *   s   *      3    #
# #*# # # # # # #*# # # # # # #
#  1        *p  *  *          #
###############################
