3 13 31
###############################
#      ** *  1 * 2 *  * * *   #
# # # #*# # #*#*# # # #*#*#*# #
#  x*  b  ***  *  1   * 2 * * #
# # # # # #*# # #*#*# # # # #*#
#      f   x **  *  *   1     #
# # # # # # # # # #*# #*# # # #
#*  *  b   *  *      *     2  #
# # # # #*# # # #*#*# # # #*#*#
#* 3  **  *   s   *  b   3*   #
# #*# # # # # # #*# # # # # # #
#       5   *   *  *      * p #
###############################
