4 13 31
###############################
#p     ** *  1 * 2 *  * * *   #
# # # #*# # #*#*# # # #*#*#*# #
#   *  b  ***  *  1   * 2 * * #
# # # # # #*# # #*#*# # # # #*#
# 3    f     **  *  *   1     #
# # # # # # # # # #*# #*# # # #
#*  *  b   *  *  1   *     2  #
# # # # #*# # # #*#*# # # # # #
#* 3  **  *   s   *  b   3    #
# #*# # # # # # #*# # # # # # #
#       5   *   *  *        x #
###############################
