5 13 31
###############################
#      ** *  1 * 2 *  * * * x #
# # # #*# # #*#*# # # #*#*#*# #
#   *  b  ***  *  1   * 2 * * #
# # # # # #*# # #*#*# # # # #*#
# 3          **  *  *   1     #
# # # # # # # # # #*# #*# # # #
#*  *  b   *  *  1   *  f  2  #
# # # # #*# # # #*#*# # # # # #
#* 3  **  *   s   *  b   3    #
# #*# # # # # # #*# # # # # # #
#p    * 5   *   *  *   3      #
###############################
